############################
#. . . . . . ##. . . . . . #
#.####.#####.##.#####.####.#
#.####.#####.##.#####.####.#
#. . . . . . . . . . . . . #
#.####.##.########.##.####.#
#. . . ##. . ##. . ##. . . #
######.#####.##.#####.######
     #.##. . . . . ##.#
     #.##.###--###.##.#
######.##.#      #.##.######
. . . . . #      #. . . . . 
######.##.#      #.##.######
     #.##.########.##.#
     #.##. . . . . ##.#
######.##.########.##.######
#. . . . . . ##. . . . . . #
#.####.#####.##.#####.####.#
#. .##. . . . . . . . ##. .#
###.##.##.########.##.##.###
#. . . ##. . ##. . ##. . . #
#.##########.##.##########.#
#. . . . . . . . . . . . . #
############################