############################
#............##............#
#.####.#####.##.#####.####.#
#.####.#####.##.#####.####.#
#..........................#
#.####.##.########.##.####.#
#......##....##....##......#
######.#####.##.#####.######
     #.##..........##.#
     #.##.###--###.##.#
######.##.#      #.##.######
..........#      #..........
######.##.#      #.##.######
     #.##.########.##.#
     #.##..........##.#
######.##.########.##.######
#............##............#
#.####.#####.##.#####.####.#
#...##................##...#
###.##.##.########.##.##.###
#......##....##....##......#
#.##########.##.##########.#
#..........................#
############################